{
    "name": "GoalRoom",
    "layout": [
        ["o", "o", "o", "o", "e", "o", "o", "o", "o"],
        ["o", "e", "e", "e", "e", "e", "e", "e", "o"],
        ["o", "e", "e", "e", "e", "e", "e", "o", "o"],
        ["e", "e", "e", "e", "e", "e", "b", "g", "o"],
        ["o", "e", "e", "e", "e", "e", "e", "o", "o"],
        ["o", "e", "e", "e", "e", "e", "o", "e", "o"],
        ["o", "o", "o", "o", "o", "o", "o", "o", "o"]
    ]
}